111111111111111111111111111111
100C1110000C1111100000000C1111
100000000001110000C11110000011
100001100000000001111100000001
100111110C00000000000000000001
10000000000000000000000000C011
1000P00111111000000C0110011111
11000001110C11000000011C000001
111000111000000000000110000001
1110000000000000000001100000C1
110000000000000E11100000000011
1C0000011110001111C00000001111
100000011C00000000000000000111
11000C1111000000000111C00000C1
111111111111111111111111111111