11111111
11000301
1E0P0011
1C000001
11111111