111111111111
1P0000E110C1
100110000001
1C0000000011
110C11000C11
111111111111
