1111111111
10P0011C01
1000000001
11C0000E11
1111111111
