1111111111
1000011001
1000P00001
1100000011
1111111111
