111111111
10E110C11
111100001
110P001C1
111111111