1111111111111
100E100000C01
100000C100001
11000000000P1
1111110111111