111111
1101
1E0P11
1C0001
111111