1111111111111111
1P0000E1100C1111
10011000H0000011
1C00000001100111
1100C11100000C11
11001110C0000001
1C000000001100C1
1111111111111111
