111111111111111111111111111111
100C1110000C1111100000000C1111
1000000H0001110000C11110000011
100001100000000001111100V00001
100111110C0000000H000000000001
100000000000000V0000000000C011
100P000111111000000C0110011111
11000001110C11000000011C000001
111000111000000000000110000001
11100000000V00H0000001100000C1
1100000000000000E1100000000011
1C000001110001111C000000001111
10000V011C0000000000H000000111
11000C1111000000000111C00000C1
111111111111111111111111111111