1111111111111111
1P0000E1100C1111
10011000H0000011
1C00000001100111
1100C111000V0C11
11111100C0000001
110C00H0101100C1
1111111111111111